%%%%%%%%%%%%%%%
%             %
%             %
%             %
%             %
%             %
%             %
%%%%%%%%%%%%%%%