%%%%%%%%%%
%        %
%        %
%        %
%%%%%%%%%%